2, 3, 4, 5, 6, 7, 3, 8,
3, 5, 9, 10, 11, 3, 12, 13,
14, 15, 16, 4, 3, 17, 3, 11,
4, 5, 18, 19, 20, 3, 21, 5,
22, 10, 23, 0, 0, 0, 0, 0,
0, 0, 0, 0, 0, 0, 0, 0