2  2  2  2  2  2  2  2  2  2  2  2  2  2  2  2  2  2  2  2  2  2  2  2  2  2  2  2  2  2  2  2  2  2  2  2  2  2  2  2  2  2  2  2  2  2  2  2  2  2  2  2  2  2  2  2  2  2  2  2  2  2  2  2  2  2  2  2  2  2  2  2  2  2  2  2  2  2  2  2  2  2  2  2  2  2  2  2  2  2  2  2  2  2  2  2  2  2  2  2  2  2  2  2  2  2  2  2  2  2  2  2  2  2  2  2  2  2  2  2  2  2  2  2  2  2  2  2  2  2  2  2  2  2  2  2  2  2  2  2  2  2  2  2  2  2  2  2  2  3  2  2  2  3  2  4  1  1  1  1  1  1  1  1  1  1  1  1  1  1  1  1  1  1  1    
2  2  2  2  2  2  2  2  2  2  2  2  2  2  2  2  2  2  2  2  2  2  2  2  2  2  2  2  2  2  2  2  2  2  2  2  2  2  2  2  2  2  5  2  2  2  2  3  2  2  5  2  2  2  2  2  2  2  2  2  2  2  2  2  2  2  2  2  2  2  2  2  2  2  2  2  2  2  2  2  2  2  2  2  2  2  2  2  2  2  2  2  2  2  2  2  2  2  2  2  2  2  2  2  2  2  2  2  2  2  2  2  2  2  2  2  2  2  2  2  6  2  5  2  2  2  2  2  2  2  2  2  2  2  2  2  2  2  2  2  2  2  2  2  2  2  2  2  2  2  2  2  2  2  2  4  1  1  1  1  1  1  1  1  1  1  1  1  1  1  1  1  1  1  1    
2  2  2  2  2  2  2  3  2  2  2  2  2  2  2  2  6  2  2  2  2  3  2  2  2  2  2  2  2  2  2  2  2  2  2  2  2  2  2  2  2  2  2  2  2  2  2  2  2  2  2  2  6  2  2  2  2  2  2  2  2  2  2  2  2  2  2  2  2  2  2  2  2  2  2  2  2  2  2  2  2  2  2  2  2  3  2  2  2  2  2  2  2  2  2  2  2  2  2  2  2  3  2  2  2  2  2  2  2  2  2  2  2  2  2  2  2  2  2  2  2  2  2  2  2  2  2  2  2  2  2  2  2  2  2  2  2  2  2  2  2  2  2  2  2  2  2  2  2  2  2  2  2  2  2  4  1  1  1  1  1  1  1  1  1  1  1  1  1  1  1  1  1  1  1    
2  2  2  2  2  2  2  2  2  2  2  2  2  2  2  2  2  2  2  2  2  2  2  2  2  2  2  2  2  2  2  2  2  2  2  2  2  3  5  2  2  2  2  2  2  2  2  3  2  2  2  2  2  2  2  2  2  2  2  2  2  2  2  2  2  2  2  2  2  2  2  2  2  2  2  2  2  2  2  3  2  2  2  2  2  2  2  2  2  2  2  2  2  2  2  2  2  2  2  2  2  2  2  2  2  2  2  2  2  2  2  2  2  2  2  2  2  2  2  2  2  2  2  2  2  2  2  2  2  2  2  2  2  2  2  2  2  2  2  2  2  2  2  2  2  2  2  2  2  2  2  2  2  2  2  4  1  1  1  1  1  1  1  1  1  1  1  1  1  1  1  1  1  1  1    
2  2  2  2  2  2  2  2  2  2  2  2  2  2  5  2  6  2  2  2  2  2  2  3  2  2  2  2  2  2  2  2  2  2  2  2  2  2  2  2  2  2  2  2  2  2  2  2  2  2  2  2  2  2  2  2  2  2  2  2  6  2  2  2  2  2  2  2  2  2  2  2  2  2  2  2  2  2  2  2  2  2  2  2  2  2  2  2  2  2  2  2  2  2  5  2  2  2  2  2  2  2  2  2  2  3  2  2  6  2  2  2  2  2  2  2  2  2  2  2  2  2  2  2  2  2  2  2  2  2  2  2  2  2  2  2  2  2  2  2  2  2  2  2  2  2  2  2  2  2  2  2  2  2  2  4  1  1  1  1  1  1  1  1  1  1  1  1  1  1  1  1  1  1  1    
2  2  2  2  2  2  2  2  2  2  2  2  2  2  2  2  2  2  5  3  2  2  2  2  2  2  2  2  2  2  2  2  2  2  2  2  2  2  2  2  2  2  2  2  2  2  2  2  2  2  2  2  2  2  2  2  2  2  2  2  2  2  2  2  2  2  2  2  2  2  2  2  2  2  2  2  2  2  2  2  2  2  2  2  2  2  2  2  2  2  2  2  2  3  2  2  2  2  2  2  2  2  2  2  2  2  2  2  2  2  2  2  2  2  2  2  6  2  2  2  2  2  2  2  2  2  2  2  2  2  2  2  2  2  2  2  2  2  2  3  2  2  2  2  2  2  2  2  2  2  2  2  2  2  2  4  1  1  1  1  1  1  1  1  1  1  1  1  1  1  1  1  1  1  1    
2  2  2  2  2  2  2  2  2  2  2  2  2  2  2  2  2  2  2  2  2  2  2  2  2  2  2  2  2  2  2  2  2  2  2  2  2  2  2  2  2  2  2  2  2  2  2  2  2  2  2  2  2  2  2  2  2  2  2  2  2  2  2  2  2  2  2  2  2  2  2  2  2  2  2  2  2  2  2  2  2  2  2  2  2  2  2  2  2  2  2  3  2  2  5  2  2  2  2  2  2  2  2  2  2  2  2  2  2  2  2  2  2  2  2  2  2  2  2  2  2  2  2  2  2  2  2  2  2  2  2  2  2  2  2  2  2  2  2  2  2  2  2  2  2  2  2  2  2  2  2  2  2  2  2  4  1  1  1  1  1  1  1  1  1  1  1  1  1  1  1  1  1  1  1    
2  2  2  2  2  2  2  2  2  2  2  2  2  2  2  2  2  2  2  2  2  2  2  2  2  2  2  2  2  2  2  2  2  2  2  2  2  2  2  2  2  2  2  2  2  2  2  2  2  2  2  2  2  2  2  2  2  2  2  2  2  2  2  2  2  2  2  2  2  3  2  2  2  2  2  2  2  2  2  2  2  2  2  2  2  2  2  2  2  2  2  2  2  2  2  2  2  2  2  2  2  2  2  2  2  2  2  2  2  2  2  2  2  2  2  2  2  2  2  2  2  2  2  2  2  2  2  2  2  2  2  2  6  2  2  2  2  2  2  2  2  7  8  2  2  2  2  2  2  2  2  2  2  2  2  4  1  1  1  1  1  1  1  1  1  1  1  1  1  1  1  1  1  1  1    
2  2  2  2  2  2  2  2  2  2  2  2  2  2  2  2  2  2  2  2  2  2  2  2  2  2  2  2  2  2  2  2  2  2  2  2  2  2  2  2  2  2  2  2  2  2  2  2  2  2  2  2  2  2  2  2  2  2  2  2  2  2  2  2  2  2  2  2  2  2  2  2  2  2  5  2  6  2  2  2  2  2  2  2  2  2  2  2  2  2  2  2  2  2  2  2  2  2  2  2  2  2  2  2  2  2  2  2  2  2  2  2  2  2  2  2  2  2  2  2  2  2  2  2  2  2  2  2  2  2  2  2  2  2  2  2  2  2  2  2  2  9  10  2  2  2  2  2  2  2  2  2  2  2  2  4  1  1  1  1  1  1  1  1  1  1  1  1  1  1  1  1  1  1  1    
2  2  2  2  2  2  2  2  2  2  2  2  2  2  2  2  2  2  2  2  2  2  2  2  2  2  2  2  2  2  2  2  2  2  2  2  2  2  2  2  2  2  2  2  2  2  2  2  2  2  2  2  2  2  2  2  2  2  2  2  2  2  2  2  2  2  2  2  2  2  2  2  2  2  2  2  2  2  2  2  2  2  11  12  12  13  14  3  2  2  2  2  2  2  2  2  2  2  2  2  2  2  2  2  2  2  2  2  2  2  2  2  2  2  2  2  2  2  2  2  6  2  2  2  2  2  2  2  2  2  2  2  2  2  2  2  2  2  2  2  2  9  10  2  2  2  2  2  2  2  2  3  2  2  2  4  1  1  1  1  1  1  1  1  1  1  1  1  1  1  1  1  1  1  1    
2  2  2  2  2  2  2  2  2  2  2  2  2  2  2  2  2  2  2  2  2  2  2  2  2  2  2  2  2  2  2  2  2  2  2  2  2  2  2  2  2  2  2  2  2  2  2  2  2  2  2  2  2  2  2  2  2  2  2  2  2  2  2  2  2  2  2  2  2  2  2  2  2  2  2  2  2  2  2  2  2  2  15  16  16  17  18  2  2  2  2  2  2  2  2  2  2  2  2  2  2  2  2  2  2  2  2  2  2  2  2  2  2  2  2  2  2  2  2  2  2  2  2  2  2  2  2  2  2  2  2  2  2  2  2  2  2  2  2  2  2  9  10  2  2  2  2  2  2  2  2  2  2  2  2  4  1  1  1  1  1  1  1  1  1  1  1  1  1  1  1  1  1  1  1    
2  2  2  2  2  2  2  2  2  2  2  2  2  2  2  2  2  2  2  2  2  2  2  2  2  2  2  2  2  2  2  2  2  2  2  2  2  2  2  2  2  2  2  2  2  2  2  2  2  2  2  2  2  2  2  2  2  2  2  2  2  2  2  2  2  2  2  2  2  2  2  2  2  2  2  2  2  2  2  2  2  2  19  20  20  20  21  2  2  2  2  2  2  22  22  22  22  22  22  22  22  22  22  22  22  22  2  2  2  2  2  2  2  2  2  2  2  2  2  2  2  2  2  2  2  2  2  2  2  2  2  2  2  2  2  2  2  2  2  2  2  9  10  2  2  2  2  2  2  2  2  2  2  2  2  4  1  1  1  1  1  1  1  1  1  1  1  1  1  1  1  1  1  1  1    
2  2  2  2  2  2  2  2  2  2  2  2  2  2  2  2  2  2  2  2  2  2  2  2  2  2  2  2  2  2  2  2  2  2  2  2  2  2  2  2  2  2  2  2  2  2  2  2  2  2  2  2  2  2  2  2  2  2  2  2  2  2  2  2  2  2  2  2  2  2  2  2  2  2  2  2  2  2  2  2  2  2  2  2  2  2  2  2  22  22  22  22  2  2  2  2  2  2  2  2  2  2  2  2  2  2  2  2  2  2  2  2  2  2  2  2  2  2  2  2  2  2  2  2  2  2  2  2  2  2  2  2  2  2  2  2  2  2  2  2  2  9  10  2  2  2  2  2  2  2  2  2  2  2  2  4  1  1  1  1  1  1  1  1  1  1  1  1  1  1  1  1  1  1  1    
2  2  2  2  2  2  2  2  2  2  2  2  2  2  2  2  2  2  2  2  2  2  2  2  2  2  2  2  2  2  2  2  2  2  2  2  2  2  2  2  2  2  2  2  2  2  2  2  2  2  2  2  2  2  2  2  2  2  2  2  2  2  2  2  2  2  2  2  2  2  2  2  2  2  2  2  2  2  2  2  2  2  2  2  2  2  2  2  2  2  2  2  2  2  2  2  2  2  2  2  2  2  2  2  2  2  2  2  2  2  2  2  2  2  2  2  2  2  2  2  2  2  2  2  2  2  2  2  2  2  2  2  2  2  2  2  2  2  2  2  2  9  10  2  2  2  2  2  2  2  2  2  2  2  2  4  1  1  1  1  1  1  1  1  1  1  1  1  1  1  1  1  1  1  1    
2  2  2  2  2  2  2  2  2  2  2  2  2  2  2  2  2  2  2  2  2  2  2  2  2  2  2  2  2  2  2  2  2  2  2  2  2  2  2  2  2  2  2  2  2  2  2  2  2  2  2  2  2  2  2  2  2  2  2  2  2  2  2  2  2  2  2  2  2  2  2  2  2  2  2  2  2  2  2  2  2  2  2  2  2  2  2  2  2  2  2  2  2  2  2  2  2  2  2  2  2  2  2  2  2  2  2  2  2  2  2  2  2  2  2  2  2  2  2  2  2  2  2  2  2  2  2  2  2  2  2  2  2  2  2  2  2  2  2  2  2  9  10  2  2  2  2  2  2  2  2  2  2  2  2  4  1  1  1  1  1  1  1  1  1  1  1  1  1  1  1  1  1  1  1    
2  2  2  2  2  2  2  2  2  2  2  2  2  2  2  2  2  2  2  2  2  2  2  2  2  2  2  2  2  2  2  2  2  2  2  2  2  2  2  2  2  2  2  2  2  2  2  2  2  2  2  2  2  2  2  2  2  2  2  2  2  2  2  2  2  2  2  2  2  2  2  2  2  2  2  2  2  2  2  2  2  2  2  2  2  2  2  2  2  2  2  2  2  2  2  2  2  2  2  2  2  2  2  2  2  2  2  2  2  2  2  2  2  2  2  2  2  2  2  2  2  2  2  2  2  2  2  2  2  2  2  2  2  2  2  2  2  2  2  2  2  9  10  2  2  2  2  2  2  2  2  2  2  2  2  4  1  1  1  1  1  1  1  1  1  1  1  1  1  1  1  1  1  1  1    
2  2  2  2  2  2  2  2  2  2  2  2  2  2  2  2  2  2  2  2  23  24  25  2  2  2  2  2  2  2  2  2  2  2  2  2  2  2  2  2  2  2  2  2  2  2  2  2  2  2  2  2  2  2  2  2  2  2  2  2  2  2  2  2  2  2  2  2  2  2  2  2  2  2  2  2  2  2  2  2  2  2  2  2  2  2  2  2  2  2  2  2  2  2  2  2  2  2  2  2  2  2  2  2  2  2  2  2  2  2  2  2  2  2  2  2  2  2  2  2  2  2  2  2  2  2  2  2  2  2  2  2  2  2  2  2  2  2  2  2  2  9  10  2  2  2  2  2  2  2  2  2  2  2  2  4  1  1  1  1  1  1  1  1  1  1  1  1  1  1  1  1  1  1  1    
2  2  2  2  2  2  2  23  24  24  25  2  2  2  2  2  2  2  2  2  26  27  28  2  2  2  2  2  2  2  2  2  2  2  2  2  2  2  2  2  23  24  25  2  2  2  2  2  2  2  2  2  2  2  2  2  2  2  2  2  2  2  2  2  2  2  2  2  2  2  2  2  2  23  24  25  2  2  2  2  2  2  2  2  2  2  2  2  2  2  2  2  2  2  2  2  2  2  2  2  2  2  2  23  24  24  24  25  2  2  2  2  2  2  2  2  2  2  2  2  2  2  2  2  2  2  2  2  2  2  2  2  2  2  2  2  29  30  31  14  2  9  10  2  2  2  2  2  2  2  2  2  2  2  2  4  1  1  1  1  1  1  1  1  1  1  1  1  1  1  1  1  1  1  1    
2  2  2  2  2  2  2  26  27  27  28  2  2  2  2  2  2  2  2  2  2  2  2  2  2  2  2  2  2  2  2  2  2  2  2  2  2  2  2  2  26  27  28  2  2  2  2  2  2  2  2  2  2  2  2  2  2  2  2  2  2  2  2  2  2  2  2  2  2  2  2  2  2  26  27  28  2  2  2  2  2  2  2  2  2  2  2  2  2  2  2  2  2  2  2  2  2  2  2  2  2  2  2  26  27  27  27  28  2  2  2  2  2  2  2  2  2  2  2  2  2  2  2  2  2  2  2  2  2  2  2  2  2  2  2  2  32  33  34  18  2  9  10  2  2  23  24  25  2  2  35  36  2  2  2  4  1  1  1  1  1  1  1  1  1  1  1  1  1  1  1  1  1  1  1    
2  2  2  2  2  2  2  2  2  2  2  2  2  2  2  2  2  2  2  2  2  2  2  2  2  2  2  2  2  2  2  2  37  38  38  39  14  2  2  2  2  2  2  2  2  23  24  24  24  25  2  2  2  2  2  2  2  2  2  2  2  2  2  2  2  2  2  2  2  2  2  2  2  2  2  2  2  2  2  2  2  2  2  2  2  2  2  2  2  2  2  2  2  2  2  2  2  2  2  2  2  2  2  2  2  2  2  2  2  2  2  2  2  2  2  2  2  2  2  2  2  2  2  2  2  2  2  2  2  2  2  2  2  2  2  2  32  33  34  18  2  40  40  2  2  26  27  28  2  2  41  42  36  2  2  4  1  1  1  1  1  1  1  1  1  1  1  1  1  1  1  1  1  1  1    
2  2  2  2  2  2  2  2  2  2  2  2  2  2  2  2  2  2  2  2  2  2  2  2  2  2  2  2  2  2  2  2  43  44  44  45  18  2  2  2  2  2  2  2  2  26  27  27  27  28  2  2  2  2  2  2  2  2  2  2  2  2  2  2  2  2  2  2  2  2  2  2  2  2  2  2  2  2  2  2  2  2  2  46  47  47  47  47  47  48  14  2  2  2  2  2  2  2  2  2  2  2  2  2  2  2  2  2  2  2  2  2  2  2  2  2  2  2  2  2  2  2  2  2  2  2  2  2  2  2  2  2  2  2  2  2  32  33  34  18  2  2  2  2  2  2  2  2  2  2  41  49  50  2  2  4  1  1  1  1  1  1  51  52  1  1  1  53  54  55  1  1  1  1  1    
2  2  2  2  2  2  2  2  2  2  2  2  2  2  2  2  2  46  47  48  14  2  2  2  2  2  2  2  2  11  12  12  13  56  44  45  18  2  2  2  2  2  2  2  2  2  2  2  2  2  2  2  2  2  2  35  36  2  2  2  2  2  2  2  2  2  2  2  2  2  2  2  2  2  2  2  2  2  2  2  2  2  2  57  58  58  58  58  58  59  18  2  2  2  40  40  2  2  2  2  2  2  2  2  2  2  2  2  2  2  2  2  2  2  2  2  2  2  2  2  2  2  2  2  2  2  2  2  2  2  2  2  2  2  2  2  32  33  34  18  2  2  2  2  2  2  2  2  2  35  60  49  50  2  2  4  1  1  1  1  1  1  61  62  1  1  1  63  64  65  1  1  1  1  1    
2  2  35  36  2  2  2  2  2  2  2  2  2  2  2  2  2  57  58  59  18  2  2  2  2  2  2  2  2  66  67  67  68  69  44  45  18  2  2  2  2  2  2  2  2  2  2  2  2  2  2  2  35  36  35  60  50  35  36  2  35  36  2  2  2  2  2  2  2  2  2  2  2  2  2  2  2  2  2  2  2  11  12  12  12  12  12  13  70  59  18  2  2  2  2  2  2  2  2  2  2  2  2  2  2  2  2  2  2  2  2  2  2  2  2  2  2  2  2  2  2  2  2  2  2  2  2  2  2  2  2  2  2  2  2  2  32  33  34  18  2  2  2  2  2  2  2  2  35  60  49  49  50  2  2  4  1  1  1  1  1  1  61  51  52  1  1  71  72  73  1  1  1  1  1    
2  35  60  50  35  36  35  36  2  2  2  2  2  2  2  11  12  13  70  59  18  2  7  8  2  29  30  30  30  31  74  67  68  69  44  45  18  2  2  2  2  2  2  2  2  2  2  2  2  2  2  2  41  42  60  42  60  49  50  2  41  42  36  2  2  2  2  2  2  2  2  2  2  2  2  2  2  2  2  2  2  66  67  67  67  67  67  68  75  59  18  2  2  2  2  2  2  2  2  2  40  2  2  2  40  2  2  2  2  2  2  2  2  2  2  2  7  8  2  35  36  2  2  2  2  2  2  2  2  2  2  2  2  2  11  12  13  76  34  18  2  40  40  2  2  2  2  2  41  49  49  49  50  2  2  4  1  1  1  1  1  1  61  1  62  1  1  1  1  1  1  1  1  51  52    
2  41  42  60  49  50  41  42  36  2  2  2  2  2  2  66  67  68  75  59  18  2  9  10  2  32  33  33  33  34  77  67  29  30  30  30  30  31  14  2  2  78  79  79  79  79  79  79  2  2  2  80  81  49  49  82  49  49  50  83  60  49  50  2  2  79  79  2  2  2  2  2  2  2  2  2  2  2  2  29  30  30  30  30  30  31  74  68  75  59  18  2  2  2  2  2  2  2  2  40  40  2  2  2  40  40  2  2  2  2  2  2  7  8  2  2  9  10  2  41  42  36  2  2  2  2  2  2  2  2  2  2  2  2  66  67  68  84  34  18  2  9  10  2  2  7  8  2  41  49  49  49  42  36  2  4  1  1  1  1  1  1  61  1  51  52  1  1  1  1  1  1  1  61  62    
2  41  49  49  49  42  60  49  50  2  79  79  79  2  78  15  16  17  85  86  18  2  9  10  2  87  88  88  88  89  90  16  87  88  88  88  88  89  18  91  92  92  92  92  92  92  92  92  92  92  92  92  92  92  92  92  92  92  92  92  92  92  92  92  92  92  92  93  2  2  2  2  2  2  79  79  79  2  2  87  88  88  88  88  88  89  90  17  85  86  18  2  2  2  2  2  2  2  40  40  40  2  2  2  40  40  40  2  79  79  79  2  9  10  2  2  9  10  35  60  49  50  94  2  2  2  2  2  2  2  2  2  2  2  15  16  17  95  89  18  2  9  10  2  2  9  10  2  41  49  49  49  49  50  2  4  1  1  1  1  1  51  52  1  1  62  1  1  1  1  1  1  51  52  62    
91  92  92  92  92  92  92  92  92  92  92  92  92  92  92  96  92  92  92  92  92  92  92  92  92  92  92  92  92  92  92  92  92  92  92  92  92  92  93  97  98  98  98  98  98  98  98  98  98  98  98  98  98  98  98  98  98  98  98  98  98  98  98  98  98  98  98  99  2  2  2  2  91  92  92  92  92  92  92  92  92  92  92  92  92  92  92  92  92  92  92  92  92  93  2  2  91  92  92  92  93  2  2  2  91  92  92  92  92  92  92  92  92  92  92  92  92  92  92  92  92  92  92  92  92  92  92  92  92  92  92  92  92  92  92  92  92  92  92  93  2  91  92  92  92  92  92  92  92  92  92  92  92  92  92  92  92  92  92  92  92  92  92  92  92  92  92  92  92  92  92  92  92  92  92    
1  1  1  1  1  1  1  1  1  1  1  1  1  1  1  1  1  1  1  1  1  1  1  1  1  1  1  100  1  1  1  1  1  1  1  1  1  1  1  1  1  1  1  1  1  1  1  1  1  1  1  1  1  1  1  1  1  1  101  1  1  1  1  1  1  1  1  1  1  1  1  1  1  1  1  1  1  1  1  1  1  1  1  1  1  1  1  1  1  1  1  1  1  1  1  1  1  1  1  1  1  1  1  1  1  1  1  1  1  1  1  1  1  1  1  1  1  1  1  1  1  1  1  1  1  1  1  1  1  1  1  1  1  1  1  1  1  1  1  1  1  1  1  1  1  1  1  1  1  1  1  1  1  1  1  1  1  1  1  1  1  1  1  1  1  1  1  1  1  1  1  1  1  1  1    
1  1  1  1  1  1  1  1  1  1  1  1  1  1  1  1  1  1  1  1  1  1  1  1  1  1  1  1  1  1  1  1  1  1  1  1  1  1  1  1  1  1  1  1  1  1  1  1  1  1  1  1  1  1  1  1  1  1  1  1  1  1  1  1  1  1  1  1  1  1  1  1  1  1  1  1  1  1  1  1  1  1  1  1  1  1  1  1  1  1  1  1  1  1  1  1  1  1  1  1  1  1  1  1  1  1  1  1  1  1  1  1  1  1  1  1  1  1  1  1  1  1  1  1  1  1  1  1  1  1  1  1  1  1  1  1  1  1  1  1  1  1  1  1  1  1  1  1  1  1  1  1  1  1  1  1  1  1  1  1  1  1  1  1  1  1  1  1  1  1  1  1  1  1  1    
1  1  1  1  1  1  1  1  1  1  1  1  1  1  1  1  1  1  1  1  1  1  1  1  1  1  1  1  1  1  1  1  1  1  1  1  1  1  1  1  1  1  1  1  1  1  1  1  1  1  1  1  1  1  1  1  1  1  1  1  1  1  1  1  1  1  1  1  1  1  1  1  1  1  1  1  1  1  1  1  1  1  1  1  1  1  1  1  1  1  1  1  1  1  1  1  1  1  1  1  1  1  1  1  1  1  1  1  1  1  1  1  1  1  1  1  1  1  1  1  1  1  1  102  102  102  102  102  102  102  102  103  104  105  102  102  102  102  102  102  102  102  102  102  102  103  106  102  102  102  102  102  102  102  102  1  1  1  1  1  1  1  1  1  1  1  1  1  1  1  1  1  1  1  1    
1  1  1  1  1  1  1  1  1  1  1  1  1  1  1  1  1  1  1  1  1  1  1  1  1  1  1  1  1  1  1  1  1  1  1  1  1  1  1  1  1  1  1  1  1  1  1  1  1  1  1  1  1  1  1  1  1  1  1  1  1  1  1  1  1  1  1  1  1  1  1  1  1  1  1  1  1  1  1  1  1  1  1  1  1  1  1  1  1  1  1  1  1  1  1  1  1  1  1  1  1  1  1  1  1  1  1  1  1  1  1  1  1  1  1  1  1  1  1  1  1  1  1  102  102  102  102  102  102  102  102  107  108  1  1  1  1  1  1  1  1  1  1  1  1  107  108  102  102  102  102  102  102  102  102  1  1  1  1  1  1  1  1  1  1  1  1  1  1  1  1  1  1  1  1    
1  1  1  1  1  1  1  1  1  1  1  1  1  1  1  1  1  1  1  1  1  1  1  1  1  1  1  1  1  1  1  1  1  1  1  1  1  1  1  1  1  1  1  1  1  1  1  1  1  1  1  1  1  1  1  1  1  1  1  1  1  1  1  1  1  1  1  1  1  1  1  1  1  1  1  1  1  1  1  1  1  1  1  1  1  1  1  1  1  1  1  1  1  1  1  1  1  1  1  1  1  1  1  1  1  1  1  1  1  1  1  1  1  1  1  1  1  1  1  1  1  1  1  102  102  102  102  102  102  102  102  1  1  1  1  1  1  1  1  1  1  1  1  1  1  1  1  102  102  102  102  102  102  102  102  1  1  1  1  1  1  1  1  1  1  1  1  1  1  1  1  1  1  1  1    
1  1  1  1  1  1  1  1  1  1  1  1  1  1  1  1  1  1  1  1  1  1  1  1  1  1  1  1  1  1  1  1  1  1  1  1  1  1  1  1  1  1  1  1  1  1  1  1  1  1  1  1  1  1  1  1  1  1  1  1  1  1  1  1  1  1  1  1  1  1  1  1  1  1  1  1  1  1  1  1  1  1  1  1  1  1  1  1  1  1  1  1  1  1  1  1  1  1  1  1  1  1  1  1  1  1  1  1  1  1  1  1  1  1  1  1  1  1  1  1  1  1  1  102  102  102  102  102  102  102  102  1  1  1  1  1  1  1  1  1  1  1  1  1  1  1  1  102  102  102  102  102  102  102  102  1  1  1  1  1  1  1  1  1  1  1  1  1  1  1  1  1  1  1  1    
1  1  1  1  1  1  1  1  1  1  1  1  1  1  1  1  1  1  1  1  1  1  1  1  1  1  1  1  1  1  1  1  1  1  1  1  1  1  1  1  1  1  1  1  1  1  1  1  1  1  1  1  1  1  1  1  1  1  1  1  1  1  1  1  1  1  1  1  1  1  1  1  1  1  1  1  1  1  1  1  1  1  1  1  1  1  1  1  1  1  1  1  1  1  1  1  1  1  1  1  1  1  1  1  1  1  1  1  1  1  1  1  1  1  1  1  1  1  1  1  1  1  1  102  102  102  102  102  102  102  102  1  1  1  1  1  1  1  1  1  1  1  1  1  102  102  102  102  102  102  102  102  102  102  102  1  1  1  1  1  1  1  1  1  1  1  1  1  1  1  1  1  1  1  1    
1  1  1  1  1  1  1  1  1  1  1  1  1  1  1  1  1  1  1  1  1  1  1  1  1  1  1  1  1  1  1  1  1  1  1  1  1  1  1  1  1  1  1  1  1  1  1  1  1  1  1  1  1  1  1  1  1  1  1  1  1  1  1  1  1  1  1  1  1  1  1  1  1  1  1  1  1  1  1  1  1  1  1  1  1  1  1  1  1  1  1  1  1  1  1  1  1  1  1  1  1  1  1  1  1  1  1  1  1  1  1  1  1  1  1  1  1  1  1  1  1  1  1  102  102  102  102  102  102  102  102  1  1  1  1  1  1  1  1  1  1  1  1  102  102  102  102  102  102  102  102  102  102  102  102  1  1  1  1  1  1  1  1  1  1  1  1  1  1  1  1  1  1  1  1    
1  1  1  1  1  1  1  1  1  1  1  1  1  1  1  1  1  1  1  1  1  1  1  1  1  1  1  1  1  1  1  1  1  1  1  1  1  1  1  1  1  1  1  1  1  1  1  1  1  1  1  1  1  1  1  1  1  1  1  1  1  1  1  1  1  1  1  1  1  1  1  1  1  1  1  1  1  1  1  1  1  1  1  1  1  1  1  1  1  1  1  1  1  1  1  1  1  1  1  1  1  1  1  1  1  1  1  1  1  1  1  1  1  1  1  1  1  1  1  1  1  1  1  102  102  102  102  102  102  102  102  1  1  1  1  1  1  1  1  1  1  1  102  102  102  102  102  102  102  102  102  102  102  102  102  1  1  1  1  1  1  1  1  1  1  1  1  1  1  1  1  1  1  1  1    
1  1  1  1  1  1  1  1  1  1  1  1  1  1  1  1  1  1  1  1  1  1  1  1  1  1  1  1  1  1  1  1  1  1  1  1  1  1  1  1  1  1  1  1  1  1  1  1  1  1  1  1  1  1  1  1  1  1  1  1  1  1  1  1  1  1  1  1  1  1  1  1  1  1  1  1  1  1  1  1  1  1  1  1  1  1  1  1  1  1  1  1  1  1  1  1  1  1  1  1  1  1  1  1  1  1  1  1  1  1  1  1  1  1  1  1  1  1  1  1  1  1  1  102  102  102  102  102  102  102  102  1  1  1  1  1  1  1  1  1  1  102  102  102  102  102  102  102  102  102  102  102  102  102  102  1  1  1  1  1  1  1  1  1  1  1  1  1  1  1  1  1  1  1  1    
1  1  1  1  1  1  1  1  1  1  1  1  1  1  1  1  1  1  1  1  1  1  1  1  1  1  1  1  1  1  1  1  1  1  1  1  1  1  1  1  1  1  1  1  1  1  1  1  1  1  1  1  1  1  1  1  1  1  1  1  1  1  1  1  1  1  1  1  1  1  1  1  1  1  1  1  1  1  1  1  1  1  1  1  1  1  1  1  1  1  1  1  1  1  1  1  1  1  1  1  1  1  1  1  1  1  1  1  1  1  1  1  1  1  1  1  1  1  1  1  1  1  1  102  102  102  102  102  102  102  102  1  1  1  1  1  1  1  1  1  102  102  102  102  102  102  102  102  102  102  102  102  102  102  102  1  1  1  1  1  1  1  1  1  1  1  1  1  1  1  1  1  1  1  1    
1  1  1  1  1  1  1  1  1  1  1  1  1  1  1  1  1  1  1  1  1  1  1  1  1  1  1  1  1  1  1  1  1  1  1  1  1  1  1  1  1  1  1  1  1  1  1  1  1  1  1  1  1  1  1  1  1  1  1  1  1  1  1  1  1  1  1  1  1  1  1  1  1  1  1  1  1  1  1  1  1  1  1  1  1  1  1  1  1  1  1  1  1  1  1  1  1  1  1  1  1  1  1  1  1  1  1  1  1  1  1  1  1  1  1  1  1  1  1  1  1  1  1  102  102  102  102  102  102  102  102  1  1  1  1  1  1  1  1  102  102  102  102  102  102  102  102  102  102  102  102  102  102  102  102  1  1  1  1  1  1  1  1  1  1  1  1  1  1  1  1  1  1  1  1    
1  1  1  1  1  1  1  1  1  1  1  1  1  1  1  1  1  1  1  1  1  1  1  1  1  1  1  1  1  1  1  1  1  1  1  1  1  1  1  1  1  1  1  1  1  1  1  1  1  1  1  1  1  1  1  1  1  1  1  1  1  1  1  1  1  1  1  1  1  1  1  1  1  1  1  1  1  1  1  1  1  1  1  1  1  1  1  1  1  1  1  1  1  1  1  1  1  1  1  1  1  1  1  1  1  1  1  1  1  1  1  1  1  1  1  1  1  1  1  1  1  1  1  102  102  102  102  102  102  102  102  102  102  102  102  102  102  102  102  102  102  102  102  102  102  102  102  102  102  102  102  102  102  102  102  1  1  1  1  1  1  1  1  1  1  1  1  1  1  1  1  1  1  1  1    
