1 1 1 1 1 1 1 1 1 1 1 1 1 1 1 1 1 1 1 1 1 1 1 1 1 1 2 3 1 1 1 1  1 1 1 1 1 1 1 1 1 1 1 4 5 1 1 1  1 1 1 1 1 1 1 1 1 1 1 1 1 1 1 1  1 1 1 4 5 1 1 1 1 1 1 1 1 1 1 1  1 1 2 3 1 1 1 1 1 1 1 1 1 1 1 1  1 1 6 1 1 1 1 1 1 1 1 1 1 1 1 1  1 1 1 1 1 1 1 1 1 1 1 1 2 3 1 1  1 1 1 1 1 1 1 1 1 1 1 1 1 1 1 1  1 1 1 1 1 1 1 4 5 1 7 8 9 9 9 9  9 9 9 9 9 9 9 9 9 9 9 9 9 9 9 9
1 1 1 1 1 1 1 1 1 1 1 1 1 1 1 1 1 1 1 1 2 3 1 1 1 1 10 11 1 1 1 1  1 1 1 1 2 3 1 1 1 1 1 12 13 1 1 1  1 1 1 1 1 1 6 1 1 1 1 1 1 1 1 1  1 1 6 12 13 1 1 1 1 1 1 1 1 1 1 1  1 1 10 11 1 1 1 4 5 1 1 1 1 1 1 1  1 14 15 1 1 1 1 1 1 1 1 1 1 1 1 1  1 1 1 1 1 1 1 1 2 3 1 1 10 11 1 1  1 1 1 1 1 1 1 1 1 1 1 1 1 1 1 1  1 1 1 1 1 1 1 12 13 1 7 8 9 9 9 9  9 9 9 9 9 9 9 9 9 9 9 9 9 9 9 9                 
1 1 1 1 1 1 1 1 1 1 1 1 1 1 1 1 2 3 1 1 10 11 1 1 1 1 1 1 1 1 1 1  1 1 1 1 10 11 1 1 1 1 1 1 1 1 1 1  1 1 1 1 1 14 15 1 1 1 1 1 1 1 1 1  1 14 15 1 1 1 6 1 1 1 1 1 1 1 1 1  1 1 1 1 1 1 1 12 13 1 1 1 1 1 1 1  1 1 1 1 1 1 1 1 1 1 1 1 1 1 2 3  1 1 1 1 1 1 1 1 10 11 1 1 1 1 1 1  1 1 1 1 1 1 1 1 1 1 1 1 1 1 1 1  1 1 1 1 1 1 1 1 1 1 7 8 9 9 9 9  9 9 9 9 9 9 9 9 9 9 9 9 9 9 9 9
1 1 1 1 1 1 1 1 1 1 1 1 1 1 1 1 10 11 1 1 1 1 1 1 1 1 2 3 1 1 1 1  1 1 6 1 1 1 1 1 1 1 6 1 1 1 1 1  1 1 1 1 1 1 1 1 1 1 1 1 1 1 1 1  1 1 1 1 1 14 15 1 1 1 2 3 1 1 1 1  1 1 1 1 1 1 1 1 1 1 1 1 1 1 1 1  1 1 1 1 1 1 1 1 1 1 1 1 2 3 10 11  1 1 1 1 1 1 1 1 1 1 1 1 1 1 1 1  1 1 1 1 2 3 1 1 2 3 1 1 1 1 1 1  1 1 1 1 1 1 1 1 1 1 7 8 9 9 9 9  9 9 9 9 9 9 9 9 9 9 9 9 9 9 9 9
1 1 1 1 1 1 1 1 1 1 1 1 1 1 1 1 1 1 1 4 5 1 1 1 1 1 10 11 1 1 1 1  1 14 15 1 1 1 1 1 1 14 15 1 1 1 1 1  2 3 1 1 1 1 1 1 1 1 1 1 1 1 6 1  1 1 1 1 1 1 1 1 1 1 10 16 5 1 1 1  1 1 1 1 1 1 1 1 1 1 1 1 1 1 1 1  1 1 1 1 1 1 1 1 1 1 1 1 10 11 1 1  1 1 1 1 1 1 1 1 1 1 1 1 1 1 1 1  1 1 1 1 10 11 1 1 10 11 1 1 1 1 1 1  2 3 1 1 1 1 1 1 1 1 7 8 9 9 9 9  9 9 9 9 9 9 9 9 9 9 9 9 9 9 9 9
1 1 1 1 1 1 1 1 1 1 1 1 1 1 1 1 1 1 6 12 13 1 1 1 1 1 1 1 1 1 1 1  1 1 2 3 1 1 1 1 2 3 1 1 1 1 1 1  10 11 1 1 1 1 1 1 1 1 1 1 1 14 15 1  1 1 1 1 1 1 1 4 5 1 1 12 13 1 1 1  1 1 1 1 1 1 1 1 1 1 1 1 1 1 1 1  1 1 1 1 1 1 1 1 1 1 1 1 1 1 1 1  1 1 1 1 1 1 1 1 1 1 6 1 1 1 1 1  1 1 1 1 1 1 1 1 1 1 1 1 1 1 1 1  10 11 1 1 1 1 1 1 1 1 7 8 9 9 9 9  9 9 9 9 9 9 9 9 9 9 9 9 9 9 9 9
1 1 1 1 1 1 1 1 1 1 1 1 1 1 1 1 1 14 15 1 1 1 1 1 1 1 1 1 1 1 1 1  1 1 10 11 1 1 1 1 10 11 1 1 1 1 1 1  1 1 1 1 1 1 1 1 1 1 1 1 1 1 1 1  1 1 1 1 1 1 1 12 13 1 1 1 1 1 1 1  1 1 1 1 1 1 1 1 1 1 1 1 1 1 1 1  1 1 1 1 1 1 1 1 1 1 1 1 1 1 1 1  1 1 1 1 1 1 1 1 1 14 15 1 1 1 1 1  1 1 1 1 1 1 1 1 1 1 1 1 17 18 19 1  1 1 1 4 5 1 1 1 1 1 7 8 9 9 9 9  9 9 9 9 9 9 9 9 9 9 9 9 9 9 9 9
1 1 1 1 1 1 1 1 1 1 1 1 1 1 1 1 1 1 1 1 1 1 1 1 1 1 1 1 1 1 1 1  1 1 1 1 1 1 1 1 1 1 1 1 1 1 1 1  1 1 1 1 1 1 1 1 1 1 1 1 1 1 1 1  1 1 1 1 1 1 1 1 1 1 1 1 1 1 1 1  1 1 1 4 5 1 1 1 1 20 21 1 1 1 1 1  1 1 1 1 1 1 1 1 1 1 1 1 1 1 1 1  1 1 1 1 1 1 1 1 1 1 1 1 1 1 1 1  1 1 1 1 1 1 1 1 1 1 1 1 22 23 24 1  1 1 1 12 13 1 6 1 1 1 7 8 9 9 9 9  9 9 9 9 9 9 9 9 9 9 9 9 9 9 9 9
1 1 1 1 1 1 1 1 1 1 6 1 1 1 1 1 1 1 6 1 1 1 2 3 1 1 1 1 1 1 1 1  1 1 1 1 1 1 1 1 1 1 1 1 1 1 1 1  1 1 1 1 1 1 1 1 1 1 1 1 1 1 1 1  1 1 1 1 1 1 1 1 1 1 1 1 1 1 2 3  1 25 26 27 28 29 1 1 1 30 31 1 1 1 1 1  1 1 1 1 1 1 1 1 1 1 1 1 1 1 1 1  1 1 1 1 1 1 1 1 1 1 1 1 1 1 1 1  1 1 1 1 1 1 1 4 5 1 1 1 32 33 34 1  1 1 1 1 1 14 15 1 1 1 7 8 9 9 9 9  9 9 9 9 9 9 9 9 9 9 9 9 9 9 9 9
1 1 1 1 1 1 1 1 1 14 15 1 1 1 1 1 1 14 15 1 1 1 10 11 1 1 1 1 1 1 1 1  1 1 1 1 1 1 1 1 1 1 1 1 1 1 1 1  1 1 1 1 1 1 1 1 1 1 1 1 1 1 1 1  1 1 1 1 1 1 1 1 1 1 1 1 1 1 10 11  1 35 36 37 37 38 39 1 1 1 1 1 1 1 1 1  1 1 1 1 1 1 1 1 1 1 1 1 1 1 1 1  1 1 1 1 1 1 1 1 1 1 1 1 1 1 1 1  1 1 1 1 1 1 1 12 13 1 1 1 32 33 34 1  1 1 1 1 1 1 1 1 1 1 7 8 9 9 9 9  9 9 9 9 9 9 9 9 9 9 9 9 9 9 9 9
1 1 1 1 1 1 1 1 1 1 1 1 1 1 1 1 1 1 1 1 1 1 1 1 1 1 1 1 1 1 1 1  1 1 1 1 1 1 1 1 1 1 1 1 1 1 1 1  1 1 1 1 1 1 1 1 1 1 1 1 1 1 1 1  1 1 1 1 1 1 1 1 1 1 1 1 1 1 1 1  1 40 41 42 42 43 44 1 1 1 1 1 45 46 46 46  46 46 46 46 46 46 46 46 46 47 1 1 1 1 1 1  1 1 1 1 1 1 1 1 1 1 1 1 1 1 1 1  1 1 1 1 1 1 1 1 1 1 1 1 32 33 34 1  1 1 1 1 1 1 1 1 1 1 7 8 9 9 9 9  9 9 9 9 9 9 9 9 9 9 9 9 9 9 9 9
1 1 1 1 1 1 1 1 1 1 1 1 1 1 1 1 1 1 1 1 1 1 1 1 1 1 1 1 1 1 1 1  1 1 1 1 1 1 1 1 1 1 1 1 1 1 1 1  1 1 1 1 1 1 1 1 1 1 1 1 1 1 1 1  1 1 1 1 1 1 1 1 1 1 1 1 1 1 1 1  1 1 48 49 49 49 50 45 46 46 46 47 51 52 52 52  52 52 52 52 52 52 52 52 52 53 1 1 1 1 1 1  1 1 1 1 1 1 1 1 1 1 1 1 1 1 1 1  1 1 1 1 1 1 1 1 1 1 1 1 32 33 34 1  1 1 1 1 1 1 1 1 1 1 7 8 9 9 9 9  9 9 9 9 9 9 9 9 9 9 9 9 9 9 9 9
1 1 1 1 1 1 1 1 1 1 1 1 1 1 1 1 1 1 1 1 1 1 1 1 1 1 1 1 1 1 1 1  1 1 1 1 1 1 1 1 1 1 1 1 1 1 1 1  1 1 1 1 1 1 1 1 1 1 1 1 1 1 1 1  1 1 1 1 1 1 1 1 1 1 1 1 1 1 1 1  1 1 1 1 1 1 1 51 52 52 52 53 1 1 1 1  1 1 1 1 1 1 1 1 1 1 1 1 1 1 1 1  1 1 1 1 1 1 1 1 1 1 1 1 1 1 1 1  1 1 1 1 1 1 1 1 1 1 1 1 32 33 34 1  1 1 1 1 1 1 1 1 1 1 7 8 9 9 9 9  9 9 9 9 9 9 9 9 9 9 9 9 9 9 9 9
1 1 1 1 1 1 1 1 1 1 1 1 1 1 1 1 1 1 1 1 1 1 1 1 1 1 1 1 1 1 1 1  1 1 1 1 1 1 1 1 1 1 1 1 1 1 1 1  1 1 1 1 1 1 1 1 1 1 1 1 1 1 1 1  1 1 1 1 1 1 1 1 1 1 1 1 1 1 1 1  1 1 1 1 1 1 1 1 1 1 1 1 1 1 1 1  1 1 1 1 1 1 1 1 1 1 1 1 1 1 1 1  1 1 1 1 1 1 1 1 1 1 1 1 1 1 1 1  1 1 1 1 1 1 1 1 1 1 1 1 32 33 34 1  1 1 1 1 1 1 1 1 1 1 7 8 9 9 9 9  9 9 9 9 9 9 9 9 9 9 9 9 9 9 9 9
1 1 1 1 1 1 1 1 1 1 1 1 1 1 1 1 1 1 1 1 1 1 1 1 1 1 1 1 1 1 1 1  1 1 1 1 1 1 1 1 1 1 1 1 1 1 1 1  1 1 1 1 1 1 1 1 1 1 1 1 1 1 1 1  1 1 1 1 1 1 1 1 1 1 1 1 1 1 1 1  1 1 1 1 1 1 1 1 1 1 1 1 1 1 1 1  1 1 1 1 1 1 1 1 1 1 1 1 1 1 1 1  1 1 1 1 1 1 1 1 1 1 1 1 1 1 1 1  1 1 1 1 1 1 1 1 1 1 1 1 32 33 34 1  1 1 1 1 1 1 1 1 1 1 7 8 9 9 9 9  9 9 9 9 9 9 9 9 9 9 9 9 9 9 9 9
1 1 1 1 1 1 1 1 1 1 1 1 1 1 1 1 1 1 1 1 1 54 1 1 1 1 1 1 1 1 1 1  1 1 1 1 1 1 1 1 1 1 1 1 1 1 1 1  1 1 1 1 1 1 1 1 1 1 1 1 1 1 1 1  1 1 1 1 1 1 1 1 1 1 1 1 1 1 1 1  1 1 1 1 1 1 1 1 1 1 1 1 1 1 1 1  1 1 1 1 1 1 1 1 1 1 1 1 1 1 1 1  1 1 1 1 1 1 1 1 1 1 1 1 1 1 1 1  1 1 1 1 1 1 1 1 1 1 1 1 32 33 34 1  1 1 1 1 1 1 1 1 1 1 7 8 9 9 9 9  9 9 9 9 9 9 9 9 9 9 9 9 9 9 9 9
1 1 1 1 1 1 1 1 54 54 1 1 1 1 1 1 1 1 1 1 55 56 57 1 1 1 1 1 1 1 1 1  1 1 1 1 1 1 1 1 1 54 1 1 1 1 1 1  1 1 1 1 1 1 1 1 1 1 1 1 1 1 1 1  1 1 1 1 1 1 1 1 1 1 54 1 1 1 1 1  1 1 1 1 1 1 1 1 1 1 1 1 1 1 1 1  1 1 1 1 1 1 1 1 54 54 54 1 1 1 1 1  1 1 1 1 1 1 1 1 1 1 1 1 1 1 1 1  1 1 1 1 1 1 1 58 59 60 61 1 32 33 34 1  1 1 1 1 1 1 1 1 1 1 7 8 9 9 9 9  9 9 9 9 9 9 9 9 9 9 9 9 9 9 9 9
1 1 1 1 1 1 1 55 62 56 57 1 1 1 1 1 1 1 1 1 63 64 65 1 1 1 1 1 1 1 1 1  1 1 1 1 1 1 1 1 55 56 57 1 1 1 1 1  1 1 1 1 1 1 1 1 1 1 1 1 1 1 1 1  1 1 1 1 1 1 1 1 1 55 56 57 1 1 1 1  1 1 1 1 1 1 1 1 1 1 1 1 1 1 1 1  1 1 1 1 1 1 1 55 62 62 56 57 1 1 1 1  1 1 1 1 1 1 1 1 1 1 1 1 1 1 1 1  1 1 1 1 1 1 1 66 67 68 69 39 32 33 34 1  1 1 54 1 1 1 70 71 1 1 7 8 9 9 9 9  9 9 9 9 9 9 9 9 9 9 9 9 9 9 9 9
1 1 1 1 1 1 1 63 72 64 65 1 1 1 1 1 1 1 1 1 1 1 1 1 1 1 1 1 1 1 1 75  76 77 77 78 1 1 1 1 63 64 65 1 1 1 54 54  54 1 1 1 1 1 1 1 1 1 1 1 1 1 1 1  1 1 1 1 1 1 1 1 1 63 64 65 1 1 1 1  1 1 1 1 1 1 1 1 1 1 1 1 1 1 1 1  1 1 1 1 1 1 1 63 72 72 64 65 1 1 1 1  1 1 1 1 1 1 1 1 1 1 1 1 1 1 1 1  1 1 1 1 1 1 1 66 68 68 79 44 80 81 82 1  1 55 56 57 1 83 84 85 71 1 7 8 9 9 9 9  9 9 9 9 9 9 9 9 9 9 9 9 9 9 9 9
1 1 1 1 1 1 1 1 1 1 1 1 1 1 1 1 1 1 1 1 1 1 1 1 1 20 74 1 1 1 1 89  90 91 91 92 39 1 1 1 1 1 1 1 1 55 62 62  56 57 1 1 1 1 1 1 1 1 1 1 1 1 1 1  1 1 1 1 1 1 1 1 1 1 1 1 1 1 1 1  1 1 93 94 95 95 95 95 95 96 1 1 1 1 1 1  1 1 1 1 1 1 1 1 1 1 1 1 1 1 1 1  1 1 1 1 1 1 1 1 1 1 1 1 1 1 1 1  1 1 1 1 1 1 1 66 68 68 79 44 97 98 99 1  1 63 64 65 1 100 101 102 103 1 7 8 9 9 9 9  9 9 104 105 9 9 9 9 9 9 9 9 9 9 9 9
1 1 1 1 1 1 1 1 1 1 1 1 1 1 1 1 93 94 95 96 1 1 1 1 1 86 88 1 25 26 106 107  108 91 91 109 44 1 1 1 1 1 1 1 1 63 72 72  64 65 1 1 1 1 1 70 71 1 1 1 1 1 1 1  1 1 1 1 1 1 1 1 1 1 1 1 1 1 1 1  1 1 110 111 112 112 112 112 112 113 39 1 1 114 115 116  1 1 1 1 1 1 1 1 1 1 1 1 1 1 1 1  1 1 1 1 1 1 1 1 1 1 1 1 1 1 1 1  1 1 1 1 1 1 1 66 68 68 79 44 1 1 1 1  1 1 1 1 1 117 118 119 120 1 7 8 9 9 9 9  9 121 122 123 9 9 9 124 125 126 9 9 9 9 9 9
1 1 70 71 1 1 1 1 1 1 1 1 1 1 1 1 110 111 112 113 39 1 1 1 1 1 1 1 35 36 37 37  127 128 91 109 44 1 1 1 1 1 1 20 74 1 1 1  1 1 1 1 70 71 129 130 103 70 71 1 70 71 1 1  1 1 1 1 1 1 1 1 1 1 1 1 1 1 1 1  25 26 131 132 132 132 132 133 112 134 44 1 1 97 98 99  1 1 1 1 1 1 1 1 1 1 1 1 1 1 1 1  1 1 1 1 1 1 1 1 1 1 1 1 1 1 1 1  1 1 1 1 1 1 1 66 68 68 79 44 1 1 1 1  1 1 1 1 129 130 135 119 120 1 7 8 9 9 9 9  9 136 9 137 105 9 9 138 139 140 9 9 9 9 9 
1 129 130 103 70 71 70 71 1 1 1 1 1 1 25 26 131 133 112 134 44 17 18 19 58 59 60 60 141 142 37 37  143 144 91 109 44 1 1 1 1 1 1 86 88 1 1 1  1 1 1 83 84 145 130 146 147 84 103 83 84 85 71 1  1 1 1 1 1 1 1 1 1 1 1 1 1 1 1 1  35 36 37 37 37 37 37 148 149 134 44 20 74 1 1 1  1 1 1 114 116 1 1 114 116 1 1 1 1 1 1 1  1 1 1 17 18 19 1 70 71 1 1 20 150 150 150 21  1 1 1 1 1 25 26 151 152 68 79 44 114 115 116 1  1 1 1 83 84 135 119 119 120 1 7 8 9 9 9 9  9 136 153 122 123 9 9 154 155 156 9 9 9 104 105 9
83 84 146 147 84 157 84 85 71 1 1 1 1 1 35 36 37 148 149 134 44 22 23 24 66 67 68 68 68 158 159 160  161 162 163 164 165 61 1 1 20 74 166 166 166 166 166 166  1 1 1 117 167 102 168 102 135 119 120 117 167 102 103 1  1 166 166 1 1 1 1 1 1 1 1 1 1 1 58 59  141 169 169 169 169 142 37 143 170 134 44 86 88 1 1 1  1 1 114 171 172 1 1 173 174 116 1 1 1 1 1 17  18 19 1 22 23 24 83 84 85 71 20 175 176 176 176 177  1 1 20 21 1 35 36 37 178 179 79 44 180 181 182 1  17 18 19 100 119 119 119 119 183 71 7 8 9 9 9 9  9 136 9 9 137 105 9 9 9 9 9 9 121 122 123 9
100 101 102 135 119 184 167 102 103 1 166 166 166 1 35 37 37 143 170 134 44 32 33 34 66 68 68 68 68 79 185 186  67 68 68 68 68 69 187 106 188 189 190 190 190 190 190 191  106 106 192 193 194 195 195 195 195 195 196 193 194 195 197 106  198 190 191 199 1 1 1 1 1 1 166 166 166 1 66 67  68 68 68 68 68 158 159 143 170 134 44 1 1 1 1 1  1 114 171 200 172 1 1 173 200 174 116 1 166 166 166 22  23 24 1 32 33 34 117 167 102 201 175 176 176 176 176 202  21 1 203 202 21 35 37 37 143 204 79 44 32 33 34 1  22 23 24 100 119 119 119 101 102 103 7 8 9 9 9 9  9 205 105 153 122 123 9 9 9 9 9 9 205 105 206 9
207 195 195 195 208 209 194 195 197 198 190 190 191 106 210 211 212 213 214 215 216 217 218 219 220 221 222 222 222 223 224 225  221 222 222 222 222 223 226 227 228 228 228 228 228 228 228 228  228 228 228 228 228 228 228 228 228 228 228 228 228 228 228 228  228 228 228 229 1 1 1 230 106 198 190 190 191 106 220 221  222 222 222 222 222 223 224 213 214 215 216 106 106 199 1 230  106 231 232 232 233 1 1 234 232 232 235 198 190 190 191 217  218 219 106 217 218 236 193 194 195 237 238 238 238 238 238 238  239 106 240 238 239 210 211 212 213 241 223 242 243 218 219 106  217 218 219 207 195 195 195 195 195 197 244 245 246 246 246 246  247 248 249 246 246 250 246 246 246 246 246 247 248 249 250 251
