[SETTINGS]
#cell_size	num_col_cells	num_row_cells
300	9	2
[OBJECTS]
#index_col	index_row	object_id
0	0	6	7	8	9	10	11	12	13	14	79	80
0	1	15	16	17	18	19	20	21	22	23	24	25	26	27	28	6	7	8	9	10	11	12	13	14	112	113	114
0	2	29	30	31	32	33	34	35	15	16	17	18	19	20	21	22	23	24	25	26	27	28	112	113	114	115	116
0	3	36	37	38	39	40	41	42	43	44	45	46	47	48	49	50	51	52	53	54	55	56	57	58	59	60	61	29	30	31	32	33	34	35	115	116	117
0	4	62	63	64	65	66	67	68	69	70	71	72	36	37	38	39	40	41	42	43	44	45	46	47	48	49	50	51	52	53	54	55	56	57	58	59	60	61	117	118	119	120
0	5	73	74	75	76	77	78	62	63	64	65	66	67	68	69	70	71	72	118	119	120	121	122	123	124	82	83	84	85	1	2	4
0	6	73	74	75	76	77	78	121	122	123	124	82	83	84	85	81	1	2	4	5
0	7	82	83	84	8	81	1	2	3	4	5	125	126	127
0	8	81	3	5	125	126	127
1	0	79	80
1	1
1	2
1	3
1	4
1	5
1	6
1	7
1	8