[SETTINGS]
#cell_size	num_col_cells	num_row_cells
155	18	4
[OBJECTS]
#index_col	index_row	object_id
0	0
0	1
0	2
0	3
0	4
0	5
0	6	101	102	103	104	105
0	7	101	102	103	104	105
0	8	39	40	101	102	103	104	105
0	9	39	40
0	10	39	40
0	11
0	12	
0	13
0	14
0	15
0	16
0	17
1	0	1	27	28	29	30
1	1	1	27	28	29	30
1	2	1	27	28	29	30
1	3
1	4
1	5
1	6	101	102	103	104	105
1	7	63	101	102	103	104	105
1	8	63	101	102	103	104	105
1	9	63
1	10
1	11
1	12
1	13
1	14
1	15
1	16
1	17
2	0	60	61	78	79	1	23	24	25	26	27	28	29	30
2	1	60	61	78	79	1	23	24	25	26	27	28	29	30	31	32	16	12
2	2	61	80	2	6	81	82	83	78	79	1	23	24	25	26	27	28	29	30	31	32	16	12
2	3	61	62	2	6	80	81	82	83	16	12	31	32	33	34	35	36
2	4	61	62	3	4	5	2	6	80	81	82	83	33	34	35	36
2	5	62	33	3	4	5	34	35	36
2	6	62	3	4	5	101	102	103	104	105
2	7	84	85	86	63	62	9	10	11	3	4	5	101	102	103	104	105
2	8	84	85	86	63	8	9	10	11	37	38	101	102	103	104	105
2	9	84	85	86	63	8	9	10	11	37	38
2	10	8	37	38
2	11
2	12	44	45
2	13	44	45
2	14	44	45
2	15
2	16
2	17
3	0
3	1
3	2
3	3
3	4
3	5
3	6
3	7
3	8
3	9
3	10
3	11
3	12
3	13
3	14
3	15
3	16
3	17