[SETTINGS]
#cell_size	num_col_cells	num_row_cells
150	17	2
[OBJECTS]
#index_col	index_row	object_id
0	0	88	89	90	91	92	93	6	7	8	9	10	11	12	13	14	81	82
0	1	88	89	90	91	92	93	6	7	8	9	10	11	12	13	14	114
0	2	88	89	90	91	92	93	10	11	12	13	14	114	115	116	117	15	16	17	18	19	27	28
0	3	88	89	90	91	92	93	94	95	96	27	28	10	11	12	13	14	15	16	17	18	19	20	21	22	23	24	25	26	114	115	116	117	118
0	4	29	30	31	32	33	34	35	36	37	38	39	40	41	42	43	44	45	46	47	48	49	97	98	99	94	95	96	27	28	15	16	17	18	19	20	21	22	23	24	25	26	115	116	117	118
0	5	97	98	99	94	95	96	92	93	29	30	31	32	33	34	35	36	37	38	39	40	41	42	43	44	45	46	47	48	49	118	 130
0	6	97	98	99	92	93	50	51	52	53	54	55	56	57	58	59	29	30	31	32	33	34	35	36	37	38	39	40	41	42	43	44	45	46	47	48	49	20	21	22	23	24	25	26	119	120	 130
0	7	100	101	102	60	61	62	63	64	65	50	51	52	53	54	55	56	57	58	59	29	30	31	32	33	34	35	36	37	38	39	40	41	42	43	44	45	46	47	48	49	119	120	 130
0	8	121	122	67	68	69	70	71	72	73	74	103	104	105	106	107	108	109	110	100	101	102	62	63	64	65	60	61	50	51	52	53	54	55	56	57	58	59	119	120
0	9	75	76	77	78	79	80	103	104	105	106	107	108	109	110	100	101	102	66	67	68	69	70	71	72	73	74	62	63	64	65	60	61	121	122	123
0	10	103	104	105	106	107	108	109	110	75	76	77	78	79	80	66	67	68	69	70	71	72	73	74	63	64	65	121	122	123	124	125	126
0	11	111	112	113	75	76	77	78	79	80	84	85	86	87	66	123	124	125	126	1	2
0	12	111	112	113	4	83	84	85	86	87	75	76	77	78	79	80	1	2	124	125	126
0	13	111	112	113	127	128	129	4	5	83	84	85	86	87	1	2	125	126	127
0	14	127	128	129	83	84	85	86	87	5
0	15	127	128	129	3	5	83
0	16	3	83
1	0
1	1
1	2
1	3
1	4
1	5
1	6
1	7
1	8