[SETTINGS]
#cell_size	num_col_cells	num_row_cells
155	18	4
[OBJECTS]
#index_col	index_row	object_id
0	0
0	1
0	2
0	3
0	4
0	5
0	6	101	102	103	104	105
0	7	101	102	103	104	105
0	8	106	107	108	109	110	111	112	113	114	115	116	117	118	119	39	40	89	101	102	103	104	105
0	9	106	107	108	109	110	111	112	113	114	115	116	117	118	119	39	40	89	90
0	10	106	107	108	109	110	111	112	113	114	115	116	117	118	119	39	40	89	90
0	11	106	107	108	109	110	111	112	113	114	115	116	117	118	119	90
0	12
0	13	74	17
0	14	74	17
0	15	74	17
0	16	15
0	17	15
1	0	80	81	82	83	60	61	62	78	79	1	23	24	25	26	27	28	29	30
1	1	80	81	82	83	60	61	62	78	79	1	6	23	24	25	26	27	28	29	30	31	32	16	12
1	2	33	34	35	36	80	81	82	83	61	62	80	2	6	81	82	83	78	79	1	23	24	25	26	27	28	29	30	31	32	16	12
1	3	33	34	35	36	80	81	82	83	33	34	35	36	61	62	2	6	80	81	82	83	16	12	31	32	33	34	35	36	3	4	5
1	4	33	34	35	36	80	81	82	83	61	62	3	4	5	2	6	80	81	82	83	33	34	35	36
1	5	62	33	3	4	5	6	34	35	36	101	102	103	104	105
1	6	62	63	101	102	103	104	105	6
1	7	84	85	86	63	62	8	9	10	11	3	4	5	101	102	103	104	105
1	8	106	107	108	109	110	111	112	113	114	115	116	117	118	119	133	84	85	86	89	63	8	9	10	11	37	38
1	9	68	69	70	106	107	108	109	110	111	112	113	114	115	116	117	118	119	90	133	63	64	65	66	89	67	132	84	85	86	63	8	9	10	11	37	38
1	10	18	106	107	108	109	110	111	112	113	114	115	116	117	118	119	89	90	13	19	14
1	11	41	42	43	44	45	46	47	48	49	50	51	52	53	54	55	56	57	58	59	7	18	106	107	108	109	110	111	112	113	114	115	116	117	118	119	90	13	19	14
1	12	87	18	20	18	19	13	14	41	42	43	44	45	46	47	48	49	50	51	52	53	54	55	56	57	58	59	7	13	19	14
1	13	73	120	121	122	123	124	125	126	127	128	129	130	131	20	17	73	74	87	88	70	41	42	43	44	45	46	47	48	49	50	51	52	53	54	55	56	57	58	59	7
1	14	75	21	22	120	121	122	123	124	125	126	127	128	129	130	131	20	17	73	74	87	88	70	41	42	43	44	45	46	47	48	49	50	51	52	53	54	55	56	57	58	59	7
1	15	15	75	21	22	120	121	122	123	124	125	126	127	128	129	130	131	17	73	74	87	88	70
1	16	15	21
1	17	15
2	0	60	61	78	79	1	23	24	25	26	27	28	29	30
2	1	60	61	78	79	1	2	23	24	25	26	27	28	29	30	31	32	16	12
2	2	61	80	2	6	81	82	83	78	79	1	23	24	25	26	27	28	29	30	31	32	16	12
2	3	61	62	2	6	80	81	82	83	16	12	31	32	33	34	35	36
2	4	61	62	3	4	5	2	6	80	81	82	83	33	34	35	36
2	5	62	33	3	4	5	34	35	36
2	6	62	3	4	5	101	102	103	104	105
2	7	84	85	86	63	62	9	10	11	3	4	5	101	102	103	104	105
2	8	133	84	85	86	63	8	9	10	11	37	38	101	102	103	104	105
2	9	133	64	65	66	67	132	84	85	86	63	8	9	10	11	37	38
2	10	18	19	14	133	64	65	66	67	68	69	70	132	8	37	38	13	14
2	11	18	19	14	64	65	66	67	68	69	70	132	13	14
2	12	20	18	19	14	68	69	70	41	42	43	44	45	46	47	48	49	50	51	52	53	54	55	56	57	58	59	7	13	14
2	13	22	73	21	120	121	122	123	124	125	126	127	128	129	130	131	20	17	73	74	87	88	70	41	42	43	44	45	46	47	48	49	50	51	52	53	54	55	56	57	58	59	7
2	14	22	73	75	21	22	120	121	122	123	124	125	126	127	128	129	130	131	20	17	73	74	87	88	70	41	42	43	44	45	46	47	48	49	50	51	52	53	54	55	56	57	58	59	7
2	15	22	73	75	21	22	120	121	122	123	124	125	126	127	128	129	130	131	17	73	74	87	88	70
2	16	15	75	21	22
2	17	15	75
3	0
3	1
3	2
3	3
3	4
3	5
3	6
3	7
3	8
3	9
3	10
3	11
3	12	20	91	92	93	94	95	96	97	98	99	100
3	13	20	91	92	93	94	95	96	97	98	99	100	120	121	122	123	124	125	126	127	128	129	130	131
3	14	75	20	21	22	91	92	93	94	95	96	97	98	99	100	120	121	122	123	124	125	126	127	128	129	130	131
3	15	75	21	22	91	92	93	94	95	96	97	98	99	100	120	121	122	123	124	125	126	127	128	129	130	131
3	16	75	21	22
3	17	75