[SETTINGS]
#cell_size	num_col_cells	num_row_cells
150	17	2
[OBJECTS]
#index_col	index_row	object_id
0	0	6	7	8	9	10	11	12	13	14	79	80
0	1	86	87	88	89	90	91	6	7	8	9	10	11	12	13	14	112
0	2	86	87	88	89	90	91	10	11	12	13	14	112	113	114	115
0	3	86	87	88	89	90	91	27	28	10	11	12	13	14	15	16	17	18	19	113	114	115
0	4	92	93	94	27	28	15	16	17	18	19	20	21	22	23	24	25	26	116
0	5	95	96	97	92	93	94	29	30	31	32	33	34	35	36	37	38	39	40	41	42	43	44	45	46	47	48	49	27	28	15	16	17	18	19	20	21	22	23	24	25	26	116
0	6	95	96	97	92	93	94	50	51	52	53	54	55	56	57	58	59	29	30	31	32	33	34	35	36	37	38	39	40	41	42	43	44	45	46	47	48	49	20	21	22	23	24	25	26	116	117	118
0	7	95	96	97	60	61	50	51	52	53	54	55	56	57	58	59	29	30	31	32	33	34	35	36	37	38	39	40	41	42	43	44	45	46	47	48	49	117	118
0	8	98	99	100	62	63	64	60	61	50	51	52	53	54	55	56	57	58	59	117	118	119	120
0	9	101	102	103	104	105	106	107	108	109	110	111	98	99	100	65	66	67	68	69	70	71	72	62	63	64	60	61	119	120	121
0	10	101	102	103	104	105	106	107	108	109	110	111	98	99	100	73	74	75	76	77	78	65	66	67	68	69	70	71	72	62	63	64	119	120	121	122	123	124
0	11	128	129	130	101	102	103	104	105	106	107	108	109	110	111	73	74	75	76	77	78	65	66	67	68	69	70	71	72	122	123	124
0	12	128	129	130	4	81	82	83	84	85	73	74	75	76	77	78	122	123	124	1	2
0	13	128	129	130	4	81	82	83	84	85	1	2	125	126	127
0	14	81	82	83	84	85	5	125	126	127
0	15	81	3	5	125	126	127
0	16	81	3
1	0
1	1
1	2
1	3
1	4
1	5
1	6
1	7
1	8